ids_language_code	CNS
ids_ui_home_title	主页
ids_ui_home_newchar	新角色
ids_ui_home_login	登录
ids_ui_home_website	官方页面
ids_ui_home_credits	制作人员
ids_ui_home_server	服务器:
ids_ui_login_charlogin	角色登入 :
ids_ui_login_password	账户密码 :
ids_ui_login_lost	忘记密码?
ids_ui_newchar_name	名称 :
ids_ui_newchar_girl	女
ids_ui_newchar_boy	男
ids_ui_newchar_create	开始
ids_ui_msgbox_ok	Ok
ids_ui_msgbox_cancel	取消
ids_ui_msgbox_yes	是
ids_ui_msgbox_no	否
ids_ui_loadingscreen	载入中...
ids_ui_option_title	设定
ids_ui_option_music 音乐大小
ids_ui_option_sound	音效大小
ids_ui_option_texquality	材质质量
ids_ui_option_texhigh	高
ids_ui_option_texmid	中
ids_ui_option_texlow	低
ids_ui_option_weather	天气效果
ids_ui_option_language	语言
ids_ui_option_save	储存
ids_ui_navigator_player	玩家
ids_ui_navigator_npc	NPC
ids_ui_navigator_monster	怪物
ids_ui_privacy_notice	隐私声明
ids_ui_msgbox_accept	接受
ids_ui_msgbox_decline	拒绝
ids_ui_option_keyboard	键盘布局
ids_ui_msgbox_close	关闭
ids_ui_option_shadows	阴影质量
ids_ui_option_fullscreen	全屏
ids_ui_motion_tab_mot	动作
ids_ui_motion_tab_emo	表情
ids_ui_revival_title	复活
ids_ui_revival_lodestar	复活到生命之泉
ids_ui_charinfo_base	基础
ids_ui_charinfo_name	名称
ids_ui_charinfo_login	登入
ids_ui_charinfo_job	职业
ids_ui_charinfo_level	等级
ids_ui_charinfo_server	服务器
ids_ui_charinfo_detail	详细
ids_ui_charinfo_atk	攻击
ids_ui_charinfo_critical	暴击
ids_ui_charinfo_def	防御
ids_ui_charinfo_aspeed	攻速
ids_ui_charinfo_str	力量
ids_ui_charinfo_sta	体力
ids_ui_charinfo_dex	敏捷
ids_ui_charinfo_int	智力
ids_ui_charinfo_statpoints	技能点数
ids_ui_charinfo_apply	套用
ids_ui_charinfo_reset	重置
ids_ui_charinfo_changestate	修改技能点数
ids_ui_charinfo_apply_tooltip	套用新的点数设定
ids_ui_charinfo_reset_tooltip	还原原有点数设定
ids_ui_charinfo_plusminus_tooltip	修改技能点数后请单击套用
ids_ui_charinfo_str_tooltip	增加武器攻击力 (#cffb40000Except for wand#nc)
ids_ui_charinfo_sta_tooltip	增加防御，HP FP上限增加 \nHP, FP 回复速率增加
ids_ui_charinfo_dex_tooltip	攻击速度上升\n闪避率, 格挡率 增加\n增加暴击率\n#cffb40000提升弓的攻击力#nc
ids_ui_charinfo_int_tooltip	大量提升MP上线\n魔法伤害增加
ids_ui_charinfo_gp_tooltip	修改技能点数后请单击套用
ids_ui_tooltip_sex_male	性别: 男
ids_ui_tooltip_sex_female	性别: 女
ids_ui_tooltip_onehand	单手武器
ids_ui_tooltip_twohand	双手武器
ids_ui_tooltip_attack	攻击：
ids_ui_tooltip_def_a	防御
ids_ui_tooltip_def_b	防御
ids_ui_tooltip_attack_speed	攻击速率: %s
ids_ui_tooltip_req_job	职业需求:
ids_ui_tooltip_req_level	等级需求 : %d
ids_ui_tooltip_restore_mp	回复 MP: %d
ids_ui_tooltip_restore_hp	回复 HP: %d
ids_ui_tooltip_restore_fp	回复 FP: %d
ids_ui_tooltip_max_restore	效率增加到 %d
ids_ui_tooltip_inv_suit 套装
ids_ui_tooltip_inv_gauntlet	手套
ids_ui_tooltip_inv_boots	靴子
ids_ui_tooltip_inv_helmet	头盔
ids_ui_tooltip_inv_clo	披风
ids_ui_tooltip_inv_weapon	武器
ids_ui_tooltip_inv_guard	盾牌
ids_ui_tooltip_inv_mask	面具
ids_ui_tooltip_inv_rid	滑板
ids_ui_tooltip_inv_necklace	项链
ids_ui_tooltip_inv_ring	戒指
ids_ui_tooltip_inv_earring	耳环
ids_ui_tooltip_inv_bullet	辅助武器(箭矢, 飞镖)
ids_ui_tooltip_inv_clothes_1	流行帽子
ids_ui_tooltip_inv_clothes_2	流行服装
ids_ui_tooltip_inv_clothes_3	流行手套
ids_ui_tooltip_inv_clothes_4	流行鞋子
ids_ui_inventory_1_bag	#b1#nb 背包
ids_ui_inventory_n_bags	#b%d#nb 背包
ids_ui_iventory_bag_n	背包%d
ids_ui_tooltip_mon_lvl	Lv.
ids_ui_tooltip_mon_drop	Booty:
ids_ui_tooltip_mon_no_drop	无
ids_ui_map_moninfo	显示怪物信息
ids_ui_tooltip_delete_item	掉落此处的物品消失了
ids_ui_inventory_delete	已掉落
ids_ui_inventory_delete_confirm	确定要删除该物品？
ids_ui_inventory_delete_cnt	数目
ids_ui_dialog	对话
ids_ui_dialog_title	闲聊
ids_ui_dialog_about	询问 %s
ids_ui_option_tab_game	游戏 / 音频
ids_ui_option_tab_video	视频
ids_ui_option_pm	开启 密语 & 消息
ids_ui_instantmsg_title	消息
ids_ui_message_send	发送
ids_ui_shop_title	商店
ids_ui_shop_itemslist	物品清单
ids_ui_tooltip_price	价格: %s
ids_ui_tooltip_sellprice	售价 : %s
ids_ui_shop_filter	搜索
ids_ui_shop_level	按等级
ids_ui_shop_gender	按性别
ids_ui_shop_itemprice	售价
ids_ui_sellitem_title	已售出
ids_ui_sellitem_confirm	确定要出售该物品？
ids_ui_sellitem_qty	数目
ids_ui_sellitem_price	售价：
ids_ui_msgbox_valid	Ok
ids_ui_buyitem_title	已购买
ids_ui_buyitem_confirm	确认要购买吗？
ids_ui_buyitem_price	花费
ids_ui_option_grass	草地效果 (Beta)
ids_ui_option_showlogin	角色登入
ids_ui_tooltip_max_hp	Max. HP
ids_ui_tooltip_max_mp	Max. MP
ids_ui_tooltip_max_fp	Max. FP
ids_ui_tooltip_speed	速度
ids_ui_tooltip_atkspeed	攻击速度
ids_ui_tooltip_blockmelee	物理格挡
ids_ui_tooltip_hitrate	攻击
ids_ui_display_buffs	显示/隐藏 buffs
ids_ui_selectjob_title	选择一个新的职业